██████████████████████████████████████████████████████████████████████████████
█b██ ██ ██             ██    ██                ██ ██             ██ ██ ██ ██ █
█ ██ ██ ██ █████ ██ ██ ██ █████ █████████████████ ██ █████ ████████ ██ ██ ██ █
█ ██ ██ ██ █████ ██ ██ ██ █████ █████████████████ ██ █████ ████████ ██ ██ ██ █
█          ██ ██ ██ ██ ██    ██ ██ ██                ██ ██    ██             █
█ ██ █████ ██ ██ ████████ ██ ██ ██ ██ █████ ██ ████████ █████ ████████ █████ █
█ ██ █████ ██ ██ ████████ ██ ██ ██ ██ █████ ██ ████████ █████ ████████ █████ █
█ ██    ██    ██ ██       ██ ██ ██ ██    ██ ██ ██          ██ ██          ██ █
████ █████ ███████████ ██ █████ ██ ██ █████████████████ ████████ ██ ██ ██ ████
████ █████ ███████████ ██ █████ ██ ██ █████████████████ ████████ ██ ██ ██ ████
█       ██             ██             ██       ██ ██    ██ ██    ██ ██ ██    █
█ █████ ██ ██ ███████████ ██ ██████████████ █████ ██ ██ ██ ██ ██ ████████ ████
█ █████ ██ ██ ███████████ ██ ██████████████ █████ ██ ██ ██ ██ ██ ████████ ████
█ ██ ██ ██ ██          ██ ██       ██ ██             ██       ██       ██ ██ █
█ ██ ██ ██ ██████████████ ██ ██ █████ ██ ██████████████ ██ ██ █████ █████ ██ █
█ ██ ██ ██ ██████████████ ██ ██ █████ ██ ██████████████ ██ ██ █████ █████ ██ █
█ ██    ██       ██ ██    ██ ██                      ██ ██ ██ ██    ██       █
██████████ ██ █████ █████ ████████ █████ ██████████████████████████ ██████████
██████████ ██ █████ █████ ████████ █████ ██████████████████████████ ██████████
█          ██          ██ ██    ██    ██       ██ ██          ██ ██ ██ ██    █
████ █████ ████████████████████ ███████████ █████ █████ ████████ █████ ██ ████
████ █████ ████████████████████ ███████████ █████ █████ ████████ █████ ██ ████
█ ██    ██       ██                   ██             ██    ██    ██ ██    ██ █
█ ██ █████ ████████ ██ ████████ ███████████ ███████████ █████ █████ ██ █████ █
█ ██ █████ ████████ ██ ████████ ███████████ ███████████ █████ █████ ██ █████ █
█    ██             ██    ██          ██                      ██       ██    █
█ ██ ██ ██ ██ ████████ ████████ ██████████████ █████ █████ ████████ █████ ████
█ ██ ██ ██ ██ ████████ ████████ ██████████████ █████ █████ ████████ █████ ████
█ ██ ██ ██ ██       ██ ██                ██    ██    ██                     x█
██████████████████████████████████████████████████████████████████████████████
