██████████████████████████████████████████████████████████████████████████████
█b      ██ ██                                  ██    ██       ██ ██ ██       █
████ ██ ██ ██ █████ █████ ████████ ███████████ ██ █████ ████████ ██ ██ ███████
████ ██ ██ ██ █████ █████ ████████ ███████████ ██ █████ ████████ ██ ██ ███████
█    ██    ██ ██ ██    ██    ██ ██ ██ ██    ██ ██    ██    ██    ██ ██       █
█ ██ ██ █████ ██ ████████ █████ █████ ██ ████████ █████ ████████ ██ █████ ████
█ ██ ██ █████ ██ ████████ █████ █████ ██ ████████ █████ ████████ ██ █████ ████
█ ██ ██             ██ ██ ██                            ██    ██ ██    ██ ██ █
█ █████ █████ ██ █████ █████ ████████ ████████████████████ █████ █████ ██ ██ █
█ █████ █████ ██ █████ █████ ████████ ████████████████████ █████ █████ ██ ██ █
█ ██    ██ ██ ██       ██       ██                ██       ██ ██             █
████ █████ █████ ███████████ ██████████████████████████ ██ ██ █████ ██ ██ ██ █
████ █████ █████ ███████████ ██████████████████████████ ██ ██ █████ ██ ██ ██ █
█             ██                ██       ██             ██ ██ ██    ██ ██ ██ █
████ █████ ██ █████ █████ ████████ ███████████ █████ ██ █████ ██ █████████████
████ █████ ██ █████ █████ ████████ ███████████ █████ ██ █████ ██ █████████████
█       ██ ██    ██ ██ ██ ██ ██          ██ ██    ██ ██ ██       ██       ██ █
█ ██ ████████ ████████ █████ ██ █████ █████ ██ ███████████ █████ ████████ ██ █
█ ██ ████████ ████████ █████ ██ █████ █████ ██ ███████████ █████ ████████ ██ █
█ ██ ██ ██             ██ ██       ██                      ██ ██             █
████ ██ █████ ███████████ ██ ██ ██ ███████████ ███████████ ██ ██ ████████ ████
████ ██ █████ ███████████ ██ ██ ██ ███████████ ███████████ ██ ██ ████████ ████
█ ██       ██    ██ ██ ██    ██ ██          ██          ██    ██    ██ ██ ██ █
█ ██ █████ ████████ ██ █████ ██████████████ ██ ██ ██ █████ ███████████ █████ █
█ ██ █████ ████████ ██ █████ ██████████████ ██ ██ ██ █████ ███████████ █████ █
█       ██                         ██    ██ ██ ██ ██ ██       ██             █
████ ████████ ██ █████ █████ ██ ████████ ██ █████ ████████ ████████ █████ ██ █
████ ████████ ██ █████ █████ ██ ████████ ██ █████ ████████ ████████ █████ ██ █
█       ██    ██    ██    ██ ██          ██    ██       ██          ██    ██x█
██████████████████████████████████████████████████████████████████████████████
