****************
*         *   E*
*    *** **  ***
*    *    * ** *
*    * ****    *
*    *    *    *
*S   ** *      *
*    *  *      *
*    *     *   *
*    *  *  *   *
* *  *     *** *
*      *       *
*    *         *
****************
